********************
*     f            *
* ******* ***** *  *
*                 f*
* ******* ***** ****
*   *          f  p*
*   *             **
*g *g              *
********************